18 18
RRRRRRRRRRRRRRRRRR
RRRRAARRBBRRCCRRRR
RRFFAARRBBRRCCRRRR
RRRRFFFFFFRRFFRRRR
RRFFFFFFFFFFFFRRRR
RRRRRFFFFFFFFFRRRR
RRRRRFFFFFFFFFRRRR
RRRRFFFFFFFFFFRRRR
RRFFFFFFFFFFFFRRRR
RRFFFFFFFFFFFFRRRR
RRRRRRRRFFFFFFRRRR
RRRRRRRRFFFFFFRRRR
RRRRRRRRFFFFFFRRRR
RRRRRRRFFFFFFRRRRR
RRRRRRRRFFFFFFRRRR
RRRRRRRRFFFFFFRRRR
RRRRRRRRDDDDDDRRRR
RRRRRRRRRRRRRRRRRR
