9 10
RATBTCTDTR
RFFFFFFFFR
RFFFF32FFR
RFFFFFFFFR
RFFFF3FFFR
RFFFFFFFFR
RFFFF%%FFR
R22FFF2FFR
RRRRRRRRRR


