8 8
(TTTTTTTTTTTTTT)
LFFFFFFFFFFFFFFR
LF1FFFFFFFFFFFFR
LFFFFFFFFFFFFFFR
LFFFFFFFFFFFFFFR
LFFFFFFFFFFFFFFR
LFFFFFFFFFFFFFFR
LFFFFFFFFFFFFFFR
LFFFFFFFFFFFFFFR
LFFFFFFFFFFFF1FR
LFFFFFFFFFFFFFFR
[BBBBBBBBBBBBBB]
