18 18
RRRRRRRRRRRRRRRRRR
RRRRRRRFFFFRRRRRRR
RRRRRRRFFFFRRRRRRR
RFFFFFFFFFFFFFFFFR
RFFFFFFFFFFFFFFFFR
RFFFFFFFFFFFFFFFFR
RRRRRRRFFFFRRRRRRR
RRRRRRRFFFFRRRRRRR
RFFFFFFFFFFFFFFFFR
RFFFFFFFFFFFFFFFFR
RRRRRRRFFFFRRRRRRR
RRRRRRRFFFFRRRRRRR
RFFFFFFFFFFFFFFFFR
RFFFFFFFFFFFFFFFFR
RFFFFFFFFFFFFFFFFR
RFFFFFFFFFFFFFFFFR
RRRRRRRFFFFRRRRRRR
RRRRRRRRRRRRRRRRRR
