9 10
RATBTCTDTR
RFFFFFFFFR
RF1FFFFFFR
RFFFFFFF%R
RFFFF1FFFR
RF$$FFFFFR
RFF$FFFFFR
RFFFFF1FFR
RRRRRRRRRR


