9 10
RTATBTCTDR
RFFFFFFFFR
RF1FFFFFFR
RFFFFFFFFR
RFFFF1FFFR
RFFFFFFFFR
RFF%%FFFFR
R$FFFF1FFR
RRRRRRRRRR


