9 10
GDTD@D!O#G
GFFFFFFFFG
GFFFFFFFFG
GFF3FFF%2G
GFFFFFFFFG
GFF111111G
GFF$$$F$$G
GFFFFFFFFG
GGGGGGGGGG