18 18
RRRRRRRAAAARRRRRRR
RRRRRRRFFFFRRRRRRR
RRRRRRRFFFFRRRRRRR
RFFFFFFFFFFFFFFFFR
RFFFFFFFFFFFFFFFFR
RFFFFFFFFFFFFFFFFR
RRRRRRRFFFFRRRRRRR
RRRRRRRFFFFRRRRRRR
CFFFFFFFFFFFFFFFFB
CFFFFFFFFFFFFFFFFB
RRRRRRRFFFFRRRRRRR
RRRRRRRFFFFRRRRRRR
RFFFFFFFFFFFFFFFFR
RFFFFFFFFFFFFFFFFR
RFFFFFFFFFFFFFFFFR
RFFFFFFFFFFFFFFFFR
RRRRRRRFFFFRRRRRRR
RRRRRRRDDDDRRRRRRR
