9 10
RTATBTCTDR
RFFFFFFFFR
RF1FFFFFFR
RFFFFFFFFR
RFFFF1FFFR
RFFFFFFFFR
RFFFFFF%FR
RFFFFF1FFR
RRRRRRRRRR


