9 10
RATBTCTDTR
RFFFFFFFFR
RFFFF32FFR
RFFFFFFFFR
RFFFF3FFFR
RFFFFFFFFR
RFFFFFFFFR
R2FFFF2FFR
RRRRRRRRRR


