9 10
RATBTCTDTR
RFFFFFFFFR
RF1FFFFFFR
RFFFFFFFFR
RFFFF1FFFR
R$FF%FFFFR
RFFFFFF$FR
RFFFFF1FFR
RRRRRRRRRR


