17 19
RRRRRRRRFAFFRRRRRRR
RRRRRRRRFFFFRRRRRRR
RRFFFFFFFFFFFFFFFFR
RRFFFFFFFFFFFFFFFFR
RRFFFFFFFFFFFFFFFFR
RRRRRRRRFFFFRRRRRRR
RRRRRRRRFFFFRRRRRRR
RRFFFFFFFFFFFFFFFFR
RRFFFFFFFFFFFFFFFFR
RRRRRRRRFFFFRRRRRRR
RRRRRRRRFFFFRRRRRRR
RRFFFFFFFFFFFFFFFFR
RRFFFFFFFFFFFFFFFFR
RRFFFFFFFFFFFFFFFFR
RRFFFFFFFFFFFFFFFFR
RRRRRRRRFFFFRRRRRRR
RRRRRRRRRRRRRRRRRRR
