8 8
DTD@D!O#
FFFFFFFF
FFFFFFFF
FFFFFFF2
FFFFFFFF
F111111F
F$$$$F$F
FFFFFFFF
