9 10
RTTTTTTTTR
RFFFFFFFFR
RF1FFFFFFR
RFFFFFFFFR
RFFFF1FFFR
RFFFFFFFFR
RFFFFFFFFR
RFFFFF1FFR
RRRRRRRRRR


