9 10
RATBTCTDTR
RFFFFFFFFR
RF3FFFFFFR
RFFFFFFFFR
RFFFF2FFFR
RFFFFFFFFR
RFFFFFFFFR
RFFFFF2FFR
RRRRRRRRRR


