9 10
RATB@C!D#R
RFFFFFFFFR
RFFFFFFFFR
RFF3FFF%2R
RFFFFFFFFR
RFF111111R
RFF$$$F$$R
RFFFFFFFFR
RRRRRRRRRR