8 8
DTD@D!O#
FFFFFFFF
FFFFFFFF
FF3FFF%2
FFFFFFFF
FF111111
FF$$$F$$
FFFFFFFF
