9 10
RTATBTCTDR
RFFFFFFFFR
RF1FFFFFFR
RFFFFFFFFR
RFFFF2FFFR
RFFFFFFFFR
RFFFFFFFFR
R33FFF1FFR
RRRRRRRRRR


