9 10
RTTTTTTTTR
RFFFFFFF#R
RF1FFFFF#R
RFFFFFFF#R
RFFFF1FF#R
RFFFFFFF#R
RFFFFFFF#R
RFFFFF1F#R
RRRRRRRRRR


