18 18
RRRRRRRRRRRRRRRRRR
RRRRRRRAAAARRRRRRR
RRRRRRRFFFFRRRRRRR
RFFFFFFFFFFFFFFFFR
RFFFFFFFFFFFFFFFFR
RFFFFFFFFFFFFFFFFR
RRRRRRRFFFFRRRRRRR
RRRRRRRFFFFRRRRRRR
RCFFFFFFFFFFFFFFBR
RCFFFFFFFFFFFFFFBR
RRRRRRRFFFFRRRRRRR
RRRRRRRFFFFRRRRRRR
RFFFFFFFFFFFFFFFFR
RFFFFFFFFFFFFFFFFR
RFFFFFFFFFFFFFFFFR
RFFFFFFFFFFFFFFFFR
RRRRRRRDDDDRRRRRRR
RRRRRRRRRRRRRRRRRR
