18 18
RRRRRRRRRRRRRRRRRR
RRRRRRRAAAARRRRRRR
RFFFFFFAAAAFFFFFFR
RFFFFFFFFFFFFFFFFR
RFFFFFFFFFFFFFFFFR
RFFFFFFFFFFFFFFFFR
RRRRRRRFFFFRRRRRRR
RRRRRRRFFFFRRRRRRR
RCCFFFFFFFFFFFFBBR
RCCFFFFFFFFFFFFBBR
RRRRRRRFFFFRRRRRRR
RRRRRRRFFFFRRRRRRR
RFFFFFFFFFFFFFFFFR
RFFFFFFFFFFFFFFFFR
RFFFFFFFFFFFFFFFFR
RFFFFFFDDDDFFFFFFR
RRRRRRRDDDDRRRRRRR
RRRRRRRRRRRRRRRRRR
