18 18
RRRRRRRRRRRRRRRRRR
RRRRRRAAAAAARRRRRR
RFFFFFAAAAAAFFFFFR
RFFFFFFFFFFFFFFFFR
RFFFFFFFFFFFFFFFFR
RFFFFFFFFFFFFFFFFR
RRRRRRRFFFFRRRRRRR
RCCRRRRFFFFRRRRBBR
RCCFFFFFFFFFFFFBBR
RCCFFFFFFFFFFFFBBR
RCCRRRRFFFFRRRRBBR
RRRRRRRFFFFRRRRRRR
RFFFFFFFFFFFFFFFFR
RFFFFFFFFFFFFFFFFR
RFFFFFFFFFFFFFFFFR
RFFFFFDDDDDDFFFFFR
RRRRRRDDDDDDRRRRRR
RRRRRRRRRRRRRRRRRR
